-------------------------------------------------------------------------------------------------
-------------------------------------------------------------------------------------------------
-------------------------------------------------------------------------------------------------
-------------------------------------------------------------------------------------------------
---------------------QCCCCCCCCCCCCCCCCCCCCCCCCCCCCCCCCCCCCCCCD-----------------------------------
---------------------GWWWWWWWWWWWWWWWWWWWVWWWWWWWWWWWWWWWWWWWO-----------------------------------
---------------------G++++++++++++++++++++++++++++++++N++++++O-----------------------------------
---------------------G+++++++++++++++++++++++++++++++++++++++O-----------------------------------
---------------------G+++++++++TA++++++++++++++++TA++++++++++O---xxxxxxxxxxxxxxxxxxxxx-----------
---------------------G+++++++++LB++++++++++++++++LB++++++++++O---x;p;;V;;t;;;;;;p;x--------------
---------------------G+++++++++++++++++EM++++++++++++++++++++xxxxx;;;;;;;;;;;;;;;;x--------------
---------------------G+++++++++++++++++YR++++++++++++++++++++;;;;;;;;;;;;;;;;;;;;;x--------------
---------------------G+++++++++++++++++++++++++++++++++++++++;;;;;;;;;;;;;;;;;;;;;x--------------
---------------------GN++++++++++++++++++++++++++++++++++++++;;;;;;;;N;;;;;;;;;;p;x--------------
---------------------G+++V+++++++++++++++++++++++++++++++++++xxxxxxxxxxx;;;xxxxxxxx--------------
---------------------GCCCCCCCCCCC++++++++++++CCCCCCCCCCCCCCCCO---------Ä:::Ä---------------------
------------------------Ä::::::::J::::::::::J:::::Ä--------------------Ä:::Ä---------------------
------------------------Ä:::::N:::::sofa::::::::::Ä--------------------Ä:::Ä---------------------
------------------------Ä:::::::::::::::::::::::::ÄÄÄÄÄÄÄÄÄÄÄÄÄÄÄÄÄÄÄÄÄÄ:::Ä---------------------
------------------------Ä::::::::::::cu::::::::::::::::::::::::::::::::::::Ä---------------------
------------------------Ä::::::::::::::::::::::::::::::::::::::::::::::::::Ä---------------------
------------------------Ä::::::::::::::::::::::::::::::::::::::::::::::V::NÄ---------------------
------------------------Ä:::::V:::::::::::::::::::ÄÄÄÄÄÄÄÄÄÄÄÄÄÄÄÄÄÄÄÄÄÄÄÄÄÄ---------------------
------------------------ÄÄÄÄÄÄÄÄÄÄÄÄÄÄÄÄÄÄÄÄÄÄÄÄÄÄÄ----------------------------------------------
-------------------------------------------------------------------------------------------------
-------------------------------------------------------------------------------------------------
-------------------------------------------------------------------------------------------------