-------------------------------------------------------------------------------------------------
-------------------------------------------------------------------------------------------------
-------------------------------------------------------------------------------------------------
-------------------------------------------------------------------------------------------------
---------------------FFFFFFFFFFFFFF-----QCCCCCCCCCCCCCCCCCCCCD-----------------------------------
---------------------F************F-----GWWWWWWWWWWVWWWWWWWWWO-----------------------------------
---------------------F*****V******F-----G+N++++++++++++++++++O-----------------------------------
---------------------F********N***F-----G++++++++++++++++++++O-----------------------------------
---------------------F************F-----G+++++TA++++++TA+++++O-----------------------------------
---------------------F************F-----G+++++LB++++++LB+++++O----+++++++++----------------------
---------------------F************FFFFFFF++++++++++++++++++++O----+++++++++----------------------
---------------------F*******************+++++++++EM++++++++++++++++++V++++----------------------
---------------------F*******************+++++++++YR++++++++++++++++N++++++----------------------
---------------------F*******FFFFFFFFFFFF++++++++++++++++++++O----+++++++++----------------------
--------ÜÜÜÜÜÜÜÜÜÜÜÜÜÜ.......Ü----------G+++++TA++++++TA+++++O----+++++++++----------------------
--------Ü....................Ü----------G+++++LB++++++LB+++++O-----------------------------------
--------Ü....................Ü----------G++++++++++++++++++++O-----------------------------------
--------Ü....................Ü----------G++++++++++++++++++++O-----------------------------------
--------Ü.....N..............Ü----------G++++++++++++++++++++O-----------------------------------
--------Ü........V...........Ü----------GCCCCC++++CCCCCCCCCCCO-----------------------------------
--------ÜÜÜÜÜÜÜÜÜÜÜÜÜÜÜÜÜ++++Ü----------------++++-----------------------------------------------
------------------------Ü++++Ü----------------++++-----------------------------------------------
------------------------Ü++++Ü----------------++++-----------------------------------------------
------------------------Ü+++++++++++----------++++-----------------------------------------------
-------------------------+++++++++++++++++++++++++-----------------------------------------------
-------------------------+++++++++++++++++++++++++-----------------------------------------------
-------------------------+++++++++++++++++++++++++-----------------------------------------------
-------------------------++++V+++N++++++++++++++++-----------------------------------------------
-------------------------+++++++++++++++++++++++++-----------------------------------------------
-------------------------------------------------------------------------------------------------
-------------------------------------------------------------------------------------------------
-------------------------------------------------------------------------------------------------
-------------------------------------------------------------------------------------------------