-------------------------------------------------------------------------------------------------
-------------------------------------------------------------------------------------------------
-------------------------------------------------------------------------------------------------
-------------------------------------------------------------------------------------------------
----------------------------------------ECCCCCCCCCCCCCCCCCCCCD-----------------------------------
----------------------------------------GWWWWWWWWWW#WWWWWWWWWO-----------------------------------
----------------------------------------G++++++++++++++++++++O-----------------------------------
----------------------------------------G++++++++++++++++++++O---------+-------------------------
----------------------------------------G+++++TA++++++TA+++++O--------+++------------------------
----------------------------------------G+++++LB++++++LB+++++O------++++++-----------------------
------------------++--------------------G++++++++++++++++++++O------+++++++----------------------
------------+++++++++++-----------------G++++++++++++++++++++O------+++++++----------------------
------------+++++++++++-----------------G++++++++++++++++++++O------++++++++---------------------
------------++++++++++++----------------G++++++++++++++++++++O------++++++++---------------------
------------+++++++++++-----------------G+++++TA++++++TA+++++O------+++++++++--------------------
------------+++++++++++-----------------G+++++LB++++++LB+++++O------+++++++++--------------------
------------+++++++++++-----------------G++++++++++++++++++++O-----++++++++++--------------------
------------+++++++++++++++++++++++++++++++++++++++++++++++++++++++++++++++++--------------------
------------++++++#++++++++++++++++++++++++++++++++++++++++++++++++++++++++++--------------------
------------+++++++++++++++++++++++++++++++++++++++++++++++++++++++++++++++++--------------------
------------+++++++++++++++++++++++++++++++++++++++++++++++++++++++++++++++++--------------------
------------++++++++++++++++++++++++++++++++++++++++++++++++++++---++++++#+++--------------------
------------+++++++++++----------+++----++++++++++++++++++++++++----++++++++++-------------------
------------+++++++++++----------+++----++++++++++++++++++++++++----+++++++++--------------------
------------+++++++++++----------+++----++++++++++++++++++++++++----+++++++++--------------------
------------+++++++++++-------+++++++++-++++++++++++++++++++++++-----++++++++--------------------
------------+++++++++++-------++++++++++++++++++++++++++++++++++-------++++----------------------
------------+++++++++++-------++++++++++++++++++++++++++++++++++-------++++----------------------
-----------++++++++++++-------++++++++++++++++++++++++++++++++++-------++++----------------------
-----------++++++++++++-------++++++++++++++++++++++++++++++++++-------++++----------------------
--------+++------+++----------++++++++++++++++++++++++++++++++++-------++++----------------------
-------+++++-----+++----------++++++++++++++++++++++++++++++++++--+-+--++++----------------------
-------+++++-----+++----------++++++++++-++++++++++++++++++++++---++++-++++-------------++-------
------+++++------+++-----+++--++++++++++-+++++++++++++++++++++----+++++++++++++-----++++++-------
------++++++++---+++-----+++--++++++++++--++++++++++++++++++++---+++++++++++++++----+++-++-------
------++++++++---+++----+++++-++++++++++--+++++++++++++++++++----+++++++++#+++++----++++++++-----
------+++++++----+++----++++++++++++++++---+++++++++#++++++++---++++++++++++++++----+++++++++----
-----++-++++++---+++----++++++++++++++++----++++++++++++++++----++++++++++++++++-----++-++--+----
-----+++++++++---+++---+++++++++++++++++----++++++++++++++++---+++++++++----++++---++++++++++----
------++++++++---+++----+++++++++++++++++----+++++++++++++++---+++++++------+++++++++++++++++----
------++++++++---+++---++++++++++++++++++----+++++++++++++-----++++++-------+++++++++++++++++----
------++++++++++++++++++++++++++++++++++++---------++----------++++++-------+++++++++++++++++----
-------++++++++++++++++++++++++++++++++++++--------++-----------------------+++++++++++++++++----
--------+++++++++++++++++++++-+++++++++++++--------++-----------------------++++---++++++++++----
--------+++++++++++++++++++++-+++++++++++++--------++-------------------+---++++----+++-+++++----
-------++++++++++++++++++++++-+++++++++++++--------++-------------------+++++++-----+++++++++----
------+++++++++--++++++++++++-+++++++++------------++-------------------++++++++----+++-++++-----
------++++++++---+++---++++++----------------------+++---++-++++++++----++++++++----++++++-------
------++++++++---+++----+++++----------------------+++++++++++++++++----++++++++----++++++-------
-----+++++++++---+++----+++++----------------------+++++++++++++++++----+++++++---------++-------
-----++-++++++---+++----+++++----+-----------------+++++++++++++++++----+++----------------------
------+++++------+++------+------+++-++------------+++++++++++++++++----+++----------------------
------+++++-++---+++------------+++++++++++--------+++---+++++++++++----+++----------------------
------++++++++---+++------------+++++++++++--------++-----++++++++++----+++----------------------
------+++++------+++------------+++++++++++--------+++----++++++++++----+++----------------------
-------+++++-----+++------------++++++++++---------+++----++++++++++----+++----------------------
-------+++++-----+++------------++++++++++--+-----++++----++++++++++----+++----------------------
--------++++-----++++-----------+++++++++---+++++++++++---++++++++++----+++----------------------
-----------++++++++++++--------++++++++++---++++++++++++--++++++++++----+++----------------------
-----------++++++++++++-------++++++++++---+++++++++++++--++++++++++----+++----------------------
------------+++++++++++-------++++++++++---+++++++++++++--+++++++++----++++----------------------
------------+++++++++++-------++++++++++---+++++++++++++--+++++++++----+++++++-------------------
------------+++++++++++---------++++++++---++++++++++++---+++-+--+----++++++++-------------------
------------+++++++++++---------++++++++---++++++++++++----+----------++++++++-------------------
------------+++++++++++---------++++++++---++++++++++++--------------+++++++++-------------------
------------+++++++++++++++++----+++++++---++++++++++++--------------+++++++++-------------------
------------++++++++++++++++++--++++++++---+++++++++++++-----------+++++++++++-------------------
------------++++++++++++++++++--++++++++---+++++++++++++++++++++++++++++++++++-------------------
------------++++++++++++++++++--+++++++----+++++++++++++++++++++++++++++++++++-------------------
------------++++++++++++++++++--+++++++----+++++++++++++++++++++++++++++++++++-------------------
------------++++++++++++++++++--++++++-----+++++++++++++++++++++++++++++++++++-------------------
------------+++++++++++----+++--+++--------+++++++++++++------++++-+++++++++++-------------------
------------+++++++++++----+++--+++--------+++++++++++++-------+++---+++++++++-------------------
------------+++++++++++----+++--++++-------+++++++++++++-------+++---+++++++++-------------------
------------++++++++++++---+++--+++--------++++++++++++--------+++--++++++++++-------------------
------------+++++++++++----+++--++++----+++++++++++++++--------+++---++++++++--------------------
------------+++++++++++----++++++++++++++++++++++++++++-------++++--+++++++++--------------------
---------------------------++++++++++++++++++++++++++++------+++++--++++++++---------------------
---------------------------++++++++++++++++++++++++++++---+++++++++-++++++++---------------------
---------------------------+++++++++++++++++++++++++++++--+++++++++--+++++-----------------------
------------------------------------------++++++++++++++--++++++++-------------------------------
-------------------------------------------++++++++++++---++++++++-------------------------------
-------------------------------------------+++++++++++++--++++++++-------------------------------
--------------------------------------------+++++++++++----+++++++-------------------------------
---------------------------------------------+++++++++++---++++++--------------------------------
---------------------------------------------++++++++++-----+++++--------------------------------
----------------------------------------------++++++++++-----------------------------------------
----------------------------------------------++++++++++-----------------------------------------
-----------------------------------------------+++++++++-----------------------------------------
------------------------------------------------------+------------------------------------------
-------------------------------------------------------------------------------------------------
-------------------------------------------------------------------------------------------------
-------------------------------------------------------------------------------------------------
-------------------------------------------------------------------------------------------------
-------------------------------------------------------------------------------------------------

